map:
CHHHHHHHHD
GMFFFFFFJI
GI  Q Q GI
GI@     GI
GI  QQQ GI
GLHHHHHHKI
BFFFFFFFFE